################
#..............#
#..............#
#..............#
#..............#
#..............#
#..............#
#######.########
#.....#.#......#
#.....#.#......#
#.....#........#
#.....#.####.###
#.....#........#
#.....########.#
#..............#
################
